6f5ca309e7d4b281
0000000000000013
0000000000000013
0000000000000013
0000000000000013
0000000000000013
0000000000000013
0000000000000013
0000000000000013
0000000000000013
deadbeefdeadbeef
deadbeefdeadbeef
deadbeefdeadbeef
deadbeefdeadbeef
deadbeefdeadbeef
deadbeefdeadbeef
deadbeefdeadbeef
deadbeefdeadbeef
deadbeefdeadbeef
deadbeefdeadbeef
deadbeefdeadbeef
deadbeefdeadbeef
deadbeefdeadbeef
deadbeefdeadbeef
deadbeefdeadbeef
deadbeefdeadbeef
deadbeefdeadbeef
deadbeefdeadbeef
deadbeefdeadbeef
deadbeefdeadbeef
deadbeefdeadbeef
deadbeefdeadbeef
deadbeefdeadbeef
6f5ca309e7d4b281
00000000000010e3
0000000000000007
00000000000001e8
0000000000000464
00000000000010e3
0000000000000007
00000000000001f4
0000000000000464
00000000000010e3
0000000000000007
0000000000000200
0000000000000464
00000000000010e3
0000000000000007
000000000000020c
0000000000000464
00000000000010e3
0000000000000005
0000000000000218
0000000000000464
00000000000010e3
0000000000000005
0000000000000228
0000000000000464
00000000000010e3
0000000000000005
0000000000000238
0000000000000464
00000000000010e3
0000000000000005
0000000000000244
0000000000000464
00000000000010e3
0000000000000007
00000000000002c8
0000000000000464
00000000000010e3
0000000000000007
00000000000002d4
0000000000000464
00000000000010e3
0000000000000007
00000000000002e0
0000000000000464
00000000000010e3
0000000000000007
00000000000002ec
0000000000000464
00000000000010e3
0000000000000005
00000000000002f8
0000000000000464
00000000000010e3
0000000000000005
0000000000000308
0000000000000464
00000000000010e3
0000000000000005
0000000000000318
0000000000000464
00000000000010e3
0000000000000005
0000000000000324
0000000000000464
00000000000010e3
0000000000000007
00000000000003c8
0000000000000464
00000000000010e3
0000000000000007
00000000000003d4
0000000000000464
00000000000010e3
0000000000000007
00000000000003e0
0000000000000464
00000000000010e3
0000000000000007
00000000000003ec
0000000000000464
00000000000010e3
0000000000000005
00000000000003f8
0000000000000464
00000000000010e3
0000000000000005
0000000000000408
0000000000000464
00000000000010e3
0000000000000005
0000000000000418
0000000000000464
00000000000010e3
0000000000000005
0000000000000424
0000000000000464
deadbeefdeadbeef
deadbeefdeadbeef
deadbeefdeadbeef
deadbeefdeadbeef
deadbeefdeadbeef
deadbeefdeadbeef
deadbeefdeadbeef
deadbeefdeadbeef
deadbeefdeadbeef
deadbeefdeadbeef
deadbeefdeadbeef
deadbeefdeadbeef
deadbeefdeadbeef
deadbeefdeadbeef
deadbeefdeadbeef
deadbeefdeadbeef
deadbeefdeadbeef
deadbeefdeadbeef
deadbeefdeadbeef
deadbeefdeadbeef
deadbeefdeadbeef
deadbeefdeadbeef
deadbeefdeadbeef
deadbeefdeadbeef
deadbeefdeadbeef
deadbeefdeadbeef
deadbeefdeadbeef
deadbeefdeadbeef
deadbeefdeadbeef
deadbeefdeadbeef
deadbeefdeadbeef
deadbeefdeadbeef
6f5ca309e7d4b281
6f5ca309e7d4b281
