6f5ca309e7d4b281
0000000000000013
0000000000000013
0000000000000013
0000000000000013
0000000000000013
0000000000000013
0000000000000013
0000000000000013
0000000000000013
deadbeefdeadbeef
deadbeefdeadbeef
deadbeefdeadbeef
deadbeefdeadbeef
deadbeefdeadbeef
deadbeefdeadbeef
deadbeefdeadbeef
deadbeefdeadbeef
deadbeefdeadbeef
deadbeefdeadbeef
deadbeefdeadbeef
deadbeefdeadbeef
deadbeefdeadbeef
deadbeefdeadbeef
deadbeefdeadbeef
deadbeefdeadbeef
deadbeefdeadbeef
deadbeefdeadbeef
deadbeefdeadbeef
deadbeefdeadbeef
deadbeefdeadbeef
deadbeefdeadbeef
deadbeefdeadbeef
6f5ca309e7d4b281
00000000000010e3
0000000000000007
00000000000001e8
000000000000044c
00000000000010e3
0000000000000007
00000000000001f4
000000000000044c
00000000000010e3
0000000000000007
0000000000000200
000000000000044c
00000000000010e3
0000000000000007
000000000000020c
000000000000044c
00000000000010e3
0000000000000005
0000000000000218
000000000000044c
00000000000010e3
0000000000000005
0000000000000228
000000000000044c
00000000000010e3
0000000000000005
0000000000000238
000000000000044c
00000000000010e3
0000000000000005
0000000000000244
000000000000044c
00000000000010e3
0000000000000001
0000000000000450
0000000000000450
00000000000010e3
0000000000000001
0000000000000450
0000000000000450
00000000000010e3
0000000000000007
00000000000002c8
000000000000044c
00000000000010e3
0000000000000007
00000000000002d4
000000000000044c
00000000000010e3
0000000000000007
00000000000002e0
000000000000044c
00000000000010e3
0000000000000007
00000000000002ec
000000000000044c
00000000000010e3
0000000000000005
00000000000002f8
000000000000044c
00000000000010e3
0000000000000005
0000000000000308
000000000000044c
00000000000010e3
0000000000000005
0000000000000318
000000000000044c
00000000000010e3
0000000000000005
0000000000000324
000000000000044c
00000000000010e3
0000000000000001
0000000000000450
0000000000000450
00000000000010e3
0000000000000001
0000000000000450
0000000000000450
00000000000010e3
0000000000000007
00000000000003c8
000000000000044c
00000000000010e3
0000000000000007
00000000000003d4
000000000000044c
00000000000010e3
0000000000000007
00000000000003e0
000000000000044c
00000000000010e3
0000000000000007
00000000000003ec
000000000000044c
00000000000010e3
0000000000000005
00000000000003f8
000000000000044c
00000000000010e3
0000000000000005
0000000000000408
000000000000044c
00000000000010e3
0000000000000005
0000000000000418
000000000000044c
00000000000010e3
0000000000000005
0000000000000424
000000000000044c
00000000000010e3
0000000000000001
0000000000000450
0000000000000450
00000000000010e3
0000000000000001
0000000000000450
0000000000000450
deadbeefdeadbeef
deadbeefdeadbeef
deadbeefdeadbeef
deadbeefdeadbeef
deadbeefdeadbeef
deadbeefdeadbeef
deadbeefdeadbeef
deadbeefdeadbeef
6f5ca309e7d4b281
6f5ca309e7d4b281
