6f5ca309e7d4b281
0000000000000013
0000000000000013
0000000000000013
0000000000000013
0000000000000013
0000000000000013
0000000000000013
0000000000000013
0000000000000013
deadbeefdeadbeef
deadbeefdeadbeef
deadbeefdeadbeef
deadbeefdeadbeef
deadbeefdeadbeef
deadbeefdeadbeef
deadbeefdeadbeef
deadbeefdeadbeef
deadbeefdeadbeef
deadbeefdeadbeef
deadbeefdeadbeef
deadbeefdeadbeef
deadbeefdeadbeef
deadbeefdeadbeef
deadbeefdeadbeef
deadbeefdeadbeef
deadbeefdeadbeef
deadbeefdeadbeef
deadbeefdeadbeef
deadbeefdeadbeef
deadbeefdeadbeef
deadbeefdeadbeef
deadbeefdeadbeef
6f5ca309e7d4b281
00000000000010e3
0000000000000007
0000000000000228
0000000000000494
00000000000010e3
0000000000000007
0000000000000234
0000000000000494
00000000000010e3
0000000000000007
0000000000000240
0000000000000494
00000000000010e3
0000000000000007
000000000000024c
0000000000000494
00000000000010e3
0000000000000005
0000000000000258
0000000000000494
00000000000010e3
0000000000000005
0000000000000268
0000000000000494
00000000000010e3
0000000000000005
0000000000000278
0000000000000494
00000000000010e3
0000000000000005
0000000000000284
0000000000000494
00000000000010e3
0000000000000007
0000000000000308
0000000000000494
00000000000010e3
0000000000000007
0000000000000314
0000000000000494
00000000000010e3
0000000000000007
0000000000000320
0000000000000494
00000000000010e3
0000000000000007
000000000000032c
0000000000000494
00000000000010e3
0000000000000005
0000000000000338
0000000000000494
00000000000010e3
0000000000000005
0000000000000348
0000000000000494
00000000000010e3
0000000000000005
0000000000000358
0000000000000494
00000000000010e3
0000000000000005
0000000000000364
0000000000000494
00000000000010e3
0000000000000007
0000000000000408
0000000000000494
00000000000010e3
0000000000000007
0000000000000414
0000000000000494
00000000000010e3
0000000000000007
0000000000000420
0000000000000494
00000000000010e3
0000000000000007
000000000000042c
0000000000000494
00000000000010e3
0000000000000005
0000000000000438
0000000000000494
00000000000010e3
0000000000000005
0000000000000448
0000000000000494
00000000000010e3
0000000000000005
0000000000000458
0000000000000494
00000000000010e3
0000000000000005
0000000000000464
0000000000000494
deadbeefdeadbeef
deadbeefdeadbeef
deadbeefdeadbeef
deadbeefdeadbeef
deadbeefdeadbeef
deadbeefdeadbeef
deadbeefdeadbeef
deadbeefdeadbeef
deadbeefdeadbeef
deadbeefdeadbeef
deadbeefdeadbeef
deadbeefdeadbeef
deadbeefdeadbeef
deadbeefdeadbeef
deadbeefdeadbeef
deadbeefdeadbeef
deadbeefdeadbeef
deadbeefdeadbeef
deadbeefdeadbeef
deadbeefdeadbeef
deadbeefdeadbeef
deadbeefdeadbeef
deadbeefdeadbeef
deadbeefdeadbeef
deadbeefdeadbeef
deadbeefdeadbeef
deadbeefdeadbeef
deadbeefdeadbeef
deadbeefdeadbeef
deadbeefdeadbeef
deadbeefdeadbeef
deadbeefdeadbeef
6f5ca309e7d4b281
6f5ca309e7d4b281
